R 642982 516464

NO ./imgs/brick.xpm
SO ./imgs/blue.xpm
WE ./imgs/wood.xpm
EA ./imgs/grey.xpm

S ./imgs/barrel.xpm
F 100,0,100
C 0,0,0

11111111111111111111111
10000000001000000000001
10011110000011111111111
10000000000000000000001
10011100000010101111001
10000000001111100000011
10111100000000000001111
11111111111111111111111