NO ./north.xpm
SO ./south.xpm
EA ./east.xpm
WE ./west.xpm

C  1,1,40
F 255,1, 0

1111111111111111111111111                         1111111111111111111111111
1000000000000001111100001                         1000000011100000000101001
1000000000000000000000001                         1111000000000000000000001
100000011111000000000000111111111111111111111111111000000000000000000000001
111000000000001111000000000000000000000000000000000000000010000000000000011
111000000000000011110000111111111111111111111111111100000000000000000000001
11111111000N0000011111111                          111000000000000000000011
1000000000000000000000001                          100000000000000000000011
1111111111111111111111111                          111111111111111111111111



