1111111111
1000000001
1110001111
1000111101
1110000011
1100000001
1100000001
1100000001
1100000001
1100000001
1100000001
11000000E1
1111111111