1111111111
1E00000011
10010101011111
11110000001
1100000001111111
10000000000011
11110000000011111111111111111
1110100101010101010101
1110000001111110000001
1111111111111111111111