
F 255,1, 0
C  1,1,1


NO ./north.xpm
SO ./south.xpm
WE ./west.xpm
EA ./east.xpm

1111111111111111111111111
1000100000011111000011001
10100N1011000000011000011
1111111001101011000001001
1001001101001100010101101
1011001001111111110001111
10011000001    1100100011
1010000101111111010011001
1000110111100111111000001
1000100001100110000011011
1011110100001 10001010001
1111111111111111111111111